---#--###--#-
-#---#----##-
####---#-#-##
---##--#-#---
-#------#----
-############
-------------
############-